##################################
#   .......###..@..    ..........#
#  ..........#.....    ..........#
# ...........#............##.....#
# ...#####...##..#.........#.....#
# .......##...#..#.........#..#..#
# ....... #...#..##### ....#..#..#
# ....... #...#......#  ...#..#..#
# ...#... #...##.....#  ... ..#..#
# ...#... ##...###...#  ... ..#..#
#  ..##...##....##...#  ... ..#..#
#  ...#....##........#....  ..#..#
#.....##....##......##.... ...#..#
#......##....##....##....  ...#..#
#.......#.... ###.## ....  ...#..#
#%%%##...##...  ###  ...    ..#..#
#....#....##...     #....   ###..#
#....##...#%....   ##.....   #...#
#.... #....%%.... ##.......   ...#
#.... ##....%...............  ...#
#....  ##...###.............. %%%#
#....%%##....##......####........#
#%%#%%.###....## ....   #...%....#
#..#....##.....##  ..   #...#....#
#..#.....##.....##      #...#....#
#..##.....#......#.     #...#....#
#...###...####......   ##...#....#
#.....##....###......  #....######
#..#...##....###..... ##...#######
#..#....##.....#.....##...##     #
#..###...###...#....#.....#      #
#...###....#...#....#...###..    #
#....###...#...#....#...#....%%..#
#.....##.......#....#...#....%%..#
#.....###......#....#...#....%%..#
#.....####....##...##..##....  ..#
#.....#####...#....#...#....   ..#
#..#.. #####..#....#.......    ..#
#..#..   ###..#....##.......   ..#
#..#..    #####%%%#####....... ..#
#..#..         %%%     .  .......#
#..#..         %%%        ....#..#
#..#...        %%%        ....#..#
#..#.....      %%%   ...%.....#..#
#..#......     %%%   ...%.....#..#
#..#.........#.%%%.#....%######..#
#  ##........%.%%%.%....%........#
#   #........%.....%....%........#
################x#################
