########################################
#                        ..............#
#     ............      ...............#
#     .................................#
######%%%%#####........................#
#.............#...      ......####.....#
#.............#..#########....#..##....#
#.............#..##......#....#...#....#
#............##..##......#....#...#....#
###..........#...##......#....#...#....#
#.###%%%%#####   ##..#...#....#...#....#
#..%.........#...##..#...#....#...#....#
#@.%.........#...##..#...#....#...#....#
#..%.........#...##..#...#....##..#....#
#.##..#%%##..#...#...  ..##...##..##...#
###...#..##..#.......  ...#...#%%%%#...#
#.....#..##..........  ...#....%%%%#...#
#.....#..##..#......   ...#....%%%%#...#
#.....#..##..######    ...#....%%%%#...#
#....##..##.......#####...#....#%%%#...#
#...##...##...............##...#%%%#...#
#..##....##................#...#%%%#...#
#........##................#...##..#...#
#........####...############...#...#...#
#...........####.......####....#...#...#
######.........................#...#...#
######   ......................#...#...#
######   ####%%%######........##...#...#
#    #   ............#########.....#...#
#    #.................#    .......#...#
#   #..................#    .......#...#
#...#..........##......#    ......######
#...############......##    ......#   ##
#..................#####    ......#    #
#..................#....    ......#    #
#..................#....  ....##..#.   #
#..#################..........#%%%%..  #
#.............................#....... #
#.............................#........#
#################################x######
