#######################################################
#  ....................#.............              ...#
# .....................#............         .........#
#.......######.........#...##......              .....#
#...###############  ..#...##.. .    ......       ....#
#...#.....#.....###  ..#...##...   .......... .   ....#
#...#.....#......##  ..#...##...  ..............   ...x
#...#..#..#.......#  ..#...##...................   ...#
#...#..#..#...#...#  ..#...##.......       ......  ...#
#......#..#...#...#  ..#...###.....         .....   %%#
#......#..#..##...# ...#....##....    ..     ....   %%#
########.....#....# ........##.... .......   ....   ..#
#......#.....#...## .........#...  ......%    ...   ..#
#......#######...#  ...#######...........%%%% ....  ..#
#................#  ###..................%%%%%...   ..#
#...............##  ..................   %%%%....   ..#
####..########..#   .......              %%%.....   ..#
#%%%%%%%%%%%%#..#   .....     .........            ...#
#%%%%%%%%%%%%#..#   .....    ...............      ....#
#...........%#..#    .....  %..................    ...#
#...........%#..##   .....  %%%.................    ..#
#######.....%#...#    ..... %%%%%            ....  ...#
#...........%#...#    .....%%%%%              ...#%%%%#
#...........%#...###   ......%%    ........   ...#%%%%#
#..#####....%#.....#   ....................   ...#....#
#%%%%%%%%%%%%# ....##     ..................  ...#... #
#%%%%%%%##%%%.......###    .................  ...#... #
#..#######%%%.........##      ... #........   ...#... #
#.......####...........###        #...#       #...... #
#####...##       .............................#.....  #
#.......##         ...........................#....   #
#@......##           .........................#....   #
#######################################################
